0 0 0 0 0 0 0 0 0 0 0 0 0 0 0 0 
0 0 0 0 0 0 0 0 0 0 0 0 0 0 0 0 
0 0 85 86 87 88 89 90 91 92 93 94 95 96 0 0 
0 0 97 98 99 100 101 102 103 104 105 106 107 108 0 0 
0 0 109 110 111 112 113 114 115 116 117 118 119 4 0 0 
0 0 121 122 123 124 125 126 127 128 129 130 131 132 0 0 
0 0 133 134 135 136 137 138 139 140 141 142 143 144 0 0 
0 0 0 0 0 0 0 0 0 0 0 0 0 0 0 0 
0 0 0 0 0 0 0 0 0 0 0 0 0 0 0 0 
0 0 0 0 0 0 0 0 0 0 0 0 0 0 0 0 
0 0 0 0 0 0 0 0 0 0 0 0 0 0 0 0 
0 0 0 0 0 0 0 0 0 0 0 0 0 0 0 0 
0 0 0 0 0 0 0 0 0 0 0 0 0 0 0 0 
0 0 0 0 0 0 0 0 0 0 0 0 0 0 0 0 
0 0 0 0 0 0 0 0 0 0 0 0 0 0 0 0