0 0 0 0 0 0 0 0 0 0 0 0 0 0 0 0 
0 0 0 0 0 0 0 0 0 0 0 0 0 0 0 0 
0 0 0 0 0 0 0 0 0 0 0 0 0 0 0 0 
0 0 0 0 0 0 0 0 0 0 0 0 0 0 0 0 
0 0 0 0 0 0 0 0 0 0 0 0 0 0 0 0 
0 0 0 0 0 0 0 0 0 0 0 0 0 0 0 0 
0 0 0 0 0 0 0 0 0 0 0 0 5 6 7 8 
0 0 0 0 0 0 0 0 0 0 0 0 17 18 19 20 
25 26 27 28 0 0 0 0 0 0 0 0 29 30 31 32 
37 38 39 40 0 0 0 0 0 0 0 0 41 42 43 44 
49 50 51 52 0 0 0 0 0 0 0 0 53 54 55 56 
61 62 63 64 0 0 0 0 0 0 0 0 65 66 67 68 
73 74 75 76 0 57 58 59 45 46 47 48 77 78 79 80 
0 0 0 0 0 0 0 0 0 0 0 0 0 0 0 0 
0 0 0 0 0 0 0 0 0 0 0 0 0 0 0 0