1 1 1 1 1 1 1 1 1 1 1 1 1 1 1 1 
1 1 1 1 1 1 1 1 1 1 1 1 1 1 1 1 
0 0 0 0 0 0 0 0 0 0 0 0 0 0 0 0 
0 0 0 0 0 0 0 0 0 0 0 0 0 0 0 0 
0 0 0 0 0 0 0 0 0 0 0 0 0 0 0 0 
0 0 0 0 0 0 0 0 0 0 0 0 0 0 0 0 
0 0 0 0 0 0 0 0 0 0 0 0 0 0 0 0 
0 0 0 0 0 0 0 153 154 155 0 0 0 0 0 0 
0 0 0 0 0 0 0 165 166 167 0 0 0 0 0 0 
0 0 0 0 0 0 0 177 178 179 0 0 0 0 0 0 
0 0 0 0 145 146 147 148 149 150 151 152 0 0 0 0 
0 0 0 0 157 158 159 160 161 162 163 164 0 0 0 0 
0 0 0 0 0 57 58 59 45 46 47 48 0 0 0 0 
0 0 0 0 0 0 0 0 0 0 0 0 0 0 0 0 
0 0 0 0 0 0 0 0 0 0 0 0 0 0 0 0